Voor je ligt de AIVD kerstpuzzel van 2017.
Net als de voorgaande jaren bestaat de kerstpuzzel uit een aantal kleinere opgaven die je onafhankelijk van elkaar kunt oplossen. Voor elk van de 42 opgaven zijn punten te verdienen. Het aantal punten staat tussen haakjes in de kantlijn
voor de opgave vermeld. In sommige gevallen worden ook aan deeloplossingen punten toegekend.
De winnaar is diegene die uiteindelijk de meeste punten weet te verzamelen. De winnaar ontvangt de inmiddels traditionele beker.
Insturen van de antwoorden kan tot en met maandag 15 januari 2018, 23.59 uur. Dit doe je door het ingevulde antwoordformulier, dat je op de website www.aivd.nl/kerstpuzzel kunt vinden, voor de deadline te verzenden naar: aivdkerstpuzzel2017@minbzk.nl.
Iedereen die het antwoordformulier instuurt, krijgt na afloop zijn score toegezonden. In de loop van februari 2018 publiceren we de oplossingen en een samenvatting van de resultaten op de website.
Eventuele vragen kun je stellen per e-mail. Op vragen over hints of hulpverzoeken bij een opgave gaan we niet in. Als een opgave gewijzigd moet worden, dan komt er een erratum op de website.
Er mag uiteraard samengewerkt worden, maar we moedigen jullie aan om met niet meer dan vier personen per team mee te doen. Ook vragen we alle deelnemers nadrukkelijk geen antwoorden uit te wisselen op publieke fora voor de deadline.
Heel veel succes en plezier! 



in front of you lies the aivd Christmas puzzle from 2017. just like the previous years exists the Christmas puzzle from a number smaller ones problems That you independent from each other can to resolve in front of each from the 42 problems to be points to to deserve the number points state between parentheses in the margin in front of the assignment mention in some cases to become also to partial solutions points granted. the winner is the one That finally the most points know to collect the winner receives the in the meantime traditional cup. send in from the answers can until and with Monday 15 January 2018 23.59 hours this do you by the completed answer sheet Which you on the website www.aivd.nl/kerstpuzzel can find in front of the deadline to to send to aivdkerstpuzzel2017@minbzk.nl. everybody That the answer sheet send in gets after ending to be score sent in the walk from February 2018 to publish we the solutions and a resume from the Results on the website. Any ask kun you ask per e-mail on ask about hints or requests for assistance at a assignment to go we not in like a assignment modified must to become than coming there a erratum on the website. there allowed of course cooperated to become but we encourage you to to with not Lake than four people per team with it to to do also ask we all Attendees emphatically no answers from to change on public forums in front of the deadline. whole a lot of good luck and pleasure   

aivd : aivd
deadline : deadline
erratum : erratum
hints : hints
in : in
is : is
kun : kun
per : per
score : score
team : team
we : we
website : website
 
aan : to
aantal : number
afloop : ending
alle : all
als : like
antwoorden : answers
antwoordformulier : answer sheet
bestaat : exists
bij : at
dan : than
dat : Which
de : the
deelnemers : Attendees
deeloplossingen : partial solutions
die : That
diegene : the one
dit : this
doe : do
doen : to do
door : by
een : a
elk : each
elkaar : each other
en : and
er : there
eventuele : Any
februari : February
fora : forums
gaan : to go
geen : no
gevallen : cases
gewijzigd : modified
haakjes : parentheses
heel : whole
het : the
hulpverzoeken : requests for assistance
iedereen : everybody
ingevulde : completed
inmiddels : in the meantime
insturen : send in
instuurt : send in
januari : January
jaren : years
je : you
jullie : you
kan : can
kerstpuzzel : Christmas puzzle
kleinere : smaller ones
komt : coming
krijgt : gets
kunt : can
ligt : lies
loop : walk
maandag : Monday
maar : but
mag : allowed
mee : with it
meer : Lake
meeste : most
met : with
moedigen : encourage
moet : must
na : after
naar : to
nadrukkelijk : emphatically
net : just
niet : not
of : or
om : to
onafhankelijk : independent
ontvangt : receives
ook : also
op : on
opgave : assignment
opgaven : problems
oplossen : to resolve
oplossingen : solutions
over : about
personen : people
plezier : pleasure
publiceren : to publish
publieke : public
punten : points
resultaten : Results
samengewerkt : cooperated
samenvatting : resume
sommige : some
staat : state
stellen : ask
succes : good luck
te : to
toegezonden : sent
tot : until
traditionele : traditional
tussen : between
uit : from
uiteindelijk : finally
uiteraard : of course
uur : hours
van : from
veel : a lot of
verdienen : to deserve
vermeld : mention
verzamelen : collect
verzenden : to send
vier : four
vinden : find
voor : in front of
voorgaande : previous
vragen : ask
weet : know
winnaar : winner
wisselen : change
worden : to become
zijn : to be